1111111111111111
1P00111000011111
100C001C000C0001
1111001111111001
1C000000000000E1
1111111111111111