111111111111111111111111
1P00000000000000000000C1
111110111111111111111111
100010000C000000000000E1
100011111111111110000001
1C0000000000000000000001
111111111111111111111111