1111111111111111
1P0C0000000000E1
1111001111111001
1000000000000001
1001111111111001
10000000C0000001
1111111111111111