111111111111111111
1P000C0000000000E1
111111100011111111
100000000000000001
111111100011111111
1C000000000C000001
111111111111111111