111111111111111111
1P0011111111111111
111000000000001111
111C011111110C1111
111001111111001111
111C011111110C1111
111100000000001111
11111111E111111111
111111111111111111
